ADJP	L	NNS QP NN $ ADVP JJ VBN VBG ADJP JJR NP JJS DT FW RBR RBS SBAR RB
ADVP	R	RB RBR RBS FW ADVP TO CD JJR JJ IN NP JJS NN
CONJP	R	CC RB IN
FRAG	R	
INTJ	L	
LST	R	LS :
NAC	L	NN NNS NNP NNPS NP NAC EX $ CD QP PRP VBG JJ JJS JJR ADJP FW
PP	R	IN TO VBG VBN RP FW
PRN	L	
PRT	R	RP
QP	L	$ IN NNS NN JJ RB DT CD NCD QP JJR JJS
RRC	R	VP NP ADVP ADJP PP
S	L	TO IN VP S SBAR ADJP UCP NP
SBAR	L	WHNP WHPP WHADVP WHADJP IN DT S SQ SINV SBAR FRAG
SBARQ	L	SQ S SINV SBARQ FRAG
SINV	L	VBZ VBD VBP VB MD VP S SINV ADJP NP
SQ	L	VBZ VBD VBP VB MD VP SQ
UCP	R	
VP	L	TO VBD VBN MD VBZ VB VBG VBP VP ADJP NN NNS NP
WHADJP	L	CC WRB JJ ADJP
WHADVP	R	CC WRB
WHNP	L	WDT WP WP$ WHADJP WHPP WHNP
WHPP	R	IN TO FW
